111111111111111111111111111111
1P000C000000000000010C00000001
100010000C01000000010000000001
10000000000100C00001111100C001
100010000C01000000000000000001
100010000C01000000000C00000001
10000000000100C000000000000001
1000000C0001000000011111111111
10000000000100C000010000000001
100C0000000000000001000C001001
1000010000C000000001C000001001
100001000000000000010001111001
100C11000000000000011111000001
10111001110000C000000000000001
10100001C10000000000C000000001
101C0001C000000000000000000CE1
111111111111111111111111111111